18,18,
1,15,
16,0,
1,1,1,1,1,1,1,1,1,1,1,1,1,1,1,1,0,1,
1,0,0,0,0,0,1,1,0,1,0,1,0,0,0,1,0,1,
1,0,0,1,1,0,1,1,0,1,0,1,0,1,0,0,0,1,
1,0,0,0,1,0,0,1,0,1,0,0,0,0,0,0,0,1,
1,0,1,0,1,1,0,1,1,1,1,1,0,1,1,1,1,1,
1,0,1,1,1,1,0,1,0,0,0,1,0,0,0,0,0,1,
1,0,1,0,0,0,0,1,0,1,0,1,1,1,1,1,0,1,
1,1,1,0,1,1,0,0,0,1,0,1,0,1,1,1,0,1,
1,1,1,0,1,1,0,1,1,1,0,1,0,1,1,1,0,1,
1,0,0,0,0,0,1,0,0,0,0,0,0,0,0,1,0,1,
1,0,0,1,1,0,1,0,0,0,1,1,1,1,0,0,0,1,
1,0,0,0,1,0,0,1,0,0,1,1,1,1,0,1,1,1,
1,0,1,0,1,1,0,1,0,1,0,0,0,0,0,0,1,1,
1,0,1,1,1,1,0,1,0,1,0,1,1,0,1,0,1,1,
1,0,1,0,0,0,0,0,0,0,0,1,1,0,1,0,1,1,
1,0,1,0,1,0,1,0,1,0,1,0,1,0,1,0,0,1,
1,1,1,1,1,1,1,1,1,1,1,1,1,1,1,1,1,1,